################################
##   #######S#######  ###E   ###
#### ####    #######  ## ### ###
####  ###    #######           #
#                  #           #
#        ######## ##           #
#        ####   #  ### ####### #
#        ####   #  ### ####### #
#        ####      ### ####### #
######   ####      ### ####### #
#                              #
################################